[
    {
        "type": "map",
        "level": 1,
        "view": [
            "####################",
            "#n.pnnnnnnnngnnnnnn#",
            "#n.......nnnn....nn#",
            "#nnnnnn.nnEnnnnHnnn#",
            "#nn.Gnn.n---nGnH.nn#",
            "#.....n........H.nn#",
            "#nnnnnn.nnnnnnnH.nn#",
            "#nnEnnn.nnn....Hnnn#",
            "#nnnnnn.nnnnngnH---#",
            "#nn............Hnnn#",
            "#nnnnnnnnnnn.nnHnnn#",
            "#PSSnnnnnnnnDnnHnnn#",
            "#...nn.............#",
            "####################"
        ]
    },
    {
        "type": "map",
        "level": 2,
        "view": [
            "################################",
            "#..............................#",
            "#.............G................#",
            "#..............................#",
            "#......H...............E.......#",
            "#..............................#",
            "#..P........L..................#",
            "#..............................#",
            "################################"
        ]
    }
]