[
    {
        "type": "map",
        "level": 1,
        "view": [
            "####################",
            "#n.pnnnnnnnngnnnnnn#",
            "#n.......nnnn....nn#",
            "#nnnnnn.nnEnnnnHnnn#",
            "#nn.GGn.n---nGnH.nn#",
            "#.....n........H.nn#",
            "#nnnnnn.nnnnnnnH.nn#",
            "#nnEnnn.nnn....Hnnn#",
            "#nnnnnn.nnnnngnH---#",
            "#nn............Hnnn#",
            "#nnnn---nnnn.nnHnnn#",
            "#PnnnHnnnnnnnnnHnnn#",
            "#..................#",
            "####################"
        ]
    },
    {
        "type": "map",
        "level": 2,
        "view": [
            "################################",
            "#..............................#",
            "#.............G................#",
            "#..............................#",
            "#......H...............E.......#",
            "#..............................#",
            "#...........L..................#",
            "#..............................#",
            "################################"
        ]
    }
]